11111111111111111111
11111111111111111111
11111111111111111111
11111111111111111111
11111111111111111110
11111111111111111100
11111111111111000000
11111111100000000000
11111111000000000000
11111100000000000000
11111100000000000000
11111100000000000000
11111100000000000000
11111100000000000000
11111100000000000000
11111000000000000000
11111000000000000000
11111000000000000000
11111000000000000000
11110000000000000000