1111111111
1111110110
1110111111
1101101010
1111010101
1110101110
1011000000
1101011000
1101000000
0100100000